=================================
==*****==========================
==*****==========================
==*****==========**************==
==*****===***====**************==
==*****===***====================
==========***=======******=======
==========***=======******=======
====================******=======
=================================